*************************************************** *************************************************
*           *   *               * *           *   * *       *             *     *         *     *   *
* *** * *** * * * * *** *** *** * * ******* *** * * * * ***** *** *** *** *** * ***** * * *** * *** *
*   * * * *   *   *   * * * *       *     * * * *   * *   *     * *       *   * * * * * *     * *   *
* ******* ******* * * *** * *** ***** * *** * * ******* * *** * * *** ***** * * * * ******* ******* *
* * *   * * * *   * * * *   * *   *   * *     *       * *     * *   * *     * *   *     *           *
* * * * * * * * * *** * * * * *** ***** ***** * * * ********* * * *** * ***** *** *** *** * *** *** *
*   * *       * * * *   * *   *     *     *     * *       *   * * * * * *   * * *   *   * * *   *   *
* * *** ***** * *** * ******* *** ***** *********** *** ***** *** * * * * * *** * *** * *** *** *** *
* * *       * *   * * *   *   *   *       * *     *   * *     *   * *   * * * *   *   * * * *     * *
* *** ********* *** * *** * ***** ***** *** *** *** *** *** ***** * * ***** * ***** ***** * ******* *
*   *       *   *   *   * * * * * *         *   *   * * *     *   * * *     *   *   * * *   *     * *
* ***** * ***** * * * *** *** * ********* * *** *** * * * ***** *** * * * *** *** *** * ***** *** * *
*       *   *   * * *   * *     * *       *   *       *     *       *   * *   *   *   * * * * * * * *
* *** * *** * * * *** * * * ***** *** ***** *** *** *** ************* *** * ***** *** * * * * * * * *
* *   *       * *   * *       * * *   * *       * *   *     *       *   * * *   *       *       *   *
* *** * ******* * * * * *** *** * ***** ***** *** *** *** *** * ******* * * * *** ******* *** ***** *
*   * *   * * * * * * * * *           *       * * * * *   * * *   *       * * * * * * *   * * * *   *
* ********* * ***** * * * *** * ******* *** *** * * * ***** * ********* *** * * * * * ***** *** * * *
* *     * *     * *   *   *   *         *       *   * * * *       *     * *           *           * *
* * ***** * * * * * ********* ********* ***** ***** *** * * * *** * *** * *** * ***** *** * *** *** *
*   * *     * * *     *         *       * *   * *     *     *   * * * *   *   *   *     * *       * *
*** * * *** *** ********* ******* * ***** * *** *** ***** ******* * * *** ********* *** * ******* * *
*     * * * * *     *       *     *   *         *     *   * *     *   *   *           * *   *       *
***** *** * * *** ***** * *** ******* *** *** * * * * * *** ***** ******* * ***** * * *** ******* ***
*     *     *     * *   *   *   *     * * *   * * * * * *           * *   * * *   * *       *     * *
*** *** * * ******* *** ********* * * * * ******* *** ***** * ******* * ***** * * ******* *** ***** *
*   *   * * *       *         * * * *   *     *     *       *       *           *     *   *     *   *
* * *** * ********* * ********* * ***** * * *** * * *** ******* * ***** * ***** *** ******* * *** * *
* *     * *     *     * *         * *   * * *   * * * * *     *       * * * *   *   * *   * *     * *
* ******* * *** *** *** ******* *** *** * ***** * *** *** *** ******* * *** ***** *** *** * ***** * *
* *   *   * *       *   * * *     *   *       * *     * * * *   * *     *   * *         *     *   * *
* * * *** *** *** * *** * * * ******* ******* * ******* *** * *** *** * * *** ***** * * * ***** *** *
* * * *     *   * *   * * * * * *       *     *                     * *   *     * * * *   *     * * *
* *** *** ***** * *** * * * *** ***** *** *** * ***************** * * ***** * * * * *** *** ***** * *
* *   *   *     * *   *     *       * *     *   *   * *   *   * * * * *     * * *   * * *       *   *
* * *** * * * *** * *** * ***** *** * *** * * * * *** *** *** * ***** * *** ********* ******* *******
*     * *   *   * *     *     * *         * * * * * * *     *   *   *     * *       *   * * * *     *
***** ***** *** *** *********** *** * ***** ***** * * * *** *** *** * * *** * * * * *** * * *** *** *
*         * * *   *       * *   *   *     *     *   *   *     *       * * * * * * * * *   * *     * *
* *** *** * * *********** * *** ***** * ***** ***** ***** *** * *** * *** * * * * * * * *** * ***** *
* * * *   * *     * *       *   *   *   *   * *         * * * * *   * *       * * * * *     *       *
* * * *** *** *** * *** *** *** *** * *** *** ***** *** * * * ******* *** *********** * *** * ***** *
* * * *     * * * *     * * *     *     *   *   *     * * *   *       *   * * *       * *   *   *   *
* * *** *** * * ******* * * * * *** ******* *** *** * ***** * ********* *** * *** * * * *********** *
* * *     * *     *       *   * *   * *             *       * *   * * * *     *   * *   *         * *
* * ******* * *** * * * * * ***** *** ***** * ***** ***** * ***** * * * *** *** * *** *** ***** *** *
* *         * * * * * * *   * * * * *   * * *   *     * * *     *   *       *   * *       *   *     *
* ***** *** * * *** * ******* * * * * *** *** ***** * * *********** * *** ******* * * *** * ***** * *
* *   *   *     * * * *   * * * * * * * *   *       *   *   *     *     *     * * * *   * *   * * * *
* *** *** ******* ***** * * * * * * * * *** *** ***** *** * *** ***** * ***** * *** * *** *** * *** *
*     * * * *     *     *   *     *       * *   *   * * * *       * * *     * *     * *     * *     *
* ***** *** * *** * * ******* *** * ***** * * ***** * * * * ***** * * * * ******* * ***** *** ***** *
* *   *         * * *       * * *   *         *   *   * * *     * *   *       * * * *         *   * *
* * * ***** *** * ******* * * * *** * *** *** * * * * * * ********* * ***** * * *** ***** * * *** * *
*   *       *   *         *   *     * *     * * *   * *       *     *   *   *     * *   * * * * *   *
*** * *********** *** ***** * *** ***** * * *** *** * * * * ***** * *** * * *** * *** ******* * *** *
*   *     *   *     * *   * *   * * * * * * * *   * *   * * * *   *   * * *   * *     *     *   * * *
*** * *** * * ***** * *** ***** * * * ***** * *********** *** * * *** ************* ***** * *** * * *
* * * * *   *     * *       * * *     *     *   *   * * * *     * *   *   *     *       * *   *   * *
* * * * * *** * * ***** ***** * * * *** *** *** * *** * * ******* *** *** * *** *********** *** *****
* * * *     * * * *   * *       * *   * * *   *     *         *     *   *     *   *       *         *
* *** ***** *** *** * *** *** * ******* * ***** ******* *** *** * ***** *** *** ***** *** *** *** * *
*   *   *   *       * *   *   * *   *         * * *     * *   * *   * *   *   *       * * *     * * *
* ********* * ***** * *** ********* *** ******* * * * *** *** * * *** *** * ********* * ***** * *** *
*   *   *   * *   * *   * * *     *       *   *     *   *     * * *   *         *     *   *   *   * *
* * * ******* *** ******* * * * *** ********* * * *** ***** * * * * * ***** *** ***** * * * ******* *
* * *     * * *     * * * *   *   *           * *   *   *   * * * * *       * *   *     *     *   * *
* ******* * * * * *** * * *** *** ***** *** ***** ******* *** ******* ***** * * ***** *** *** * * * *
*     *   *   * * *     * *     *     *   * *     * *   * * * * * *   * *   * * *       *   *   *   *
* ******* * * * * * ***** * *** * * * *** ***** *** * *** * *** * * *** * * * ************* ******* *
* *         * * * *   *   *   * * * *         *   * *   *   *   *     *   *       *       *   *     *
* * ******* *** *** * *** ***** *** ***** ******* * *** * *** *** *** *** * ***** *** ******* * *** *
* *     * *     *   *     *     *     *   *     * *   *             *   * * * *         *   * * *   *
* * ***** * *********** * ******* *** * ***** ******* *********** * * *** *** * ***** * * *** * *** *
*         *       *     *     *   *   * *   *       *   *   *   * * * *   * * *   * * *       *   * *
* *** * *** ***** * *** *** *** * * * * * *** ***** *** * *** *** * *** *** * ***** * * ***** ***** *
* *   * *   *   * * *   * *     * * * *     * *   *         *     *   *   *   *       *     * *     *
* ************* * * ***** ***** *** ******* * * ***** * ********* ***** ***** *** *********** * *****
* *     * *     * * * *         * *   * * *   *   *   *     *         * * *             *   * *     *
* * * * * * *** * *** ******* * * ***** * *** *** * ***** * * *********** * *** ********* * ***** ***
* * * * *   *       *     *   * *   * *     * *     *   * * *     * * *   *   * *   *   * * *   * * *
* * *** * ******* ******* ***** * *** * *** * ***** *** *** * ***** * * *** ***** ***** *** *** * * *
*   *   *       * *   *   *   *     *     *   *   *     *       * * *   *   * *       * *   *     * *
* * * * ***** ***** *** *** *** *** *** ***** *** ********* * *** * * ***** * *** * *** * ***** *** *
* * * * *   *   *       * *   * *   *       *   *       *   *           *     *   * * *   *         *
* ***** * * * *** *** *** * ******* * ***** * *** ***** *** ***** ********* * * *** * * * *** * *** *
*   *     *         * *     *   *   * *       * * *   * * * *         *     *   * *     * *   * *   *
* ***** * ************* * ***** * *** *** ***** * * * *** * ******* *** *** ***** * ********* ***** *
*       * * *     * *   *   *   * *   *   * *     * * *         *         *     *   *       *     * *
* ********* * ***** * ******* * *** * *** * ***** *** *** * *** ******* ***** ***** ***** * *** *** *
* * * * *     * * * *     *   * *   * *     *           * * * * * * *   *         *     * *   * *   *
* * * * * * * * * * * *** * * *********** * ******* *** ***** * * * * *** ******* ***** * ***** *** *
* *   *   * *       *   *   *           * *   *       *   *   * *     *       *   * * *       *     *
* *** * * *** ***** * ******* ********* * * ************* *** * * * * *** * *** *** * *** ***** *****
* *     *   *   *     *   * *         * * * * * *     * *     * * * *   * * *   *       * *         *
* *** ***** ***** *** *** * *** ******* *** * * * ***** ***** * *********** * * *** ***** *** *******
*   *   *   *     *   *         * * * *   * *     *   *   * *   *   * *     * *       * * *   *   * *
* ********* * *** ********* ***** * * * *** *** * * *** *** ***** *** * *** *** ***** * *** ***** * *
*           *   *                         *     *                         *   *   *                 *
************************************************** **************************************************
